000 000 000 000 000 000 000 000 000 000 000 000 000 000 000 000 000 000 000 000
000 000 000 000 000 000 000 000 000 000 000 000 000 000 000 000 000 000 000 000
000 000 000 000 000 000 000 000 000 000 000 000 000 000 000 000 000 000 000 000
000 000 000 000 000 000 000 000 006 000 005 000 000 000 000 000 000 000 000 000
000 000 000 000 000 000 000 000 000 000 100 000 000 000 000 000 000 000 000 000
000 000 000 000 000 000 000 000 000 000 100 000 000 000 000 000 000 000 000 000
000 000 000 000 000 000 000 000 000 000 004 000 000 000 000 000 000 000 000 000
000 000 000 000 000 000 200 200 200 200 100 100 100 100 100 000 000 000 000 000
000 000 000 000 000 000 200 200 000 200 100 100 200 100 100 000 000 000 000 000
000 000 000 000 000 000 200 200 000 000 100 100 200 100 000 000 000 000 000 000
000 000 000 000 000 000 100 100 100 100 002 000 100 000 000 000 000 000 000 000
000 000 400 300 300 200 107 100 200 000 100 000 100 103 100 100 100 000 000 000
000 000 400 300 300 300 000 100 100 100 000 000 100 100 200 200 400 200 200 000
000 400 400 300 300 300 000 100 100 200 001 000 000 100 000 000 000 000 400 000
000 000 300 300 300 300 000 100 100 100 000 000 000 000 000 400 400 400 400 000
000 000 000 000 000 000 000 000 600 300 000 000 000 000 300 400 400 000 000 000
000 000 000 000 000 000 000 000 000 600 300 000 000 000 300 200 200 400 400 000
000 000 000 000 000 000 000 000 000 000 300 600 000 300 200 400 400 600 400 000
000 000 000 000 000 000 000 000 000 003 000 300 200 200 400 200 400 400 400 000
000 000 000 000 000 000 000 000 000 000 000 000 000 000 000 000 000 000 000 000