M   M   M   M   M   M   M   M   M   M   M   M   M   M   M   M   M   M   M   M
M   M   M   M   M   F   F   f   f   f   f   F   F   F   F   D   F   D   r   r
M   f   D   H   H   F   f   f   f   f   f   f   f   F   F   F   F   r   r   M
M   M   H   H   F   F   F   f   T   R   R   f   f   F   F   F   r   r   f   M
M   M   F   F   F   F   D   f   f   f   R   f   F   F   F   V   r   f   F   M
M   F   F   f   f   F   F   F   F   F   R   F   F   r   r   r   r   r   r   M
M   f   F   C   f   r   r   r   r   r   B   r   r   r   H   w   T   T   r   r
M   f   F   r   r   r   F   F   F   F   R   F   F   F   F   w   T   T   w   M
M   F   f   r   F   F   F   C   f   F   R   F   F   F   F   w   T   T   w   M
M   r   r   r   F   F   F   F   f   f   R   F   F   F   f   w   w   g   w   M
M   r   F   F   F   f   F   R   R   R   R   f   F   f   f   V   f   R   F   M
M   r   R   R   R   R   R   R   H   M   R   R   R   R   R   R   R   R   F   M
M   r   R   F   F   F   f   F   F   F   f   f   F   R   F   F   s   f   f   M
M   B   R   F   F   F   f   F   M   H   P   M   M   R   f   F   f   f   s   M
M   r   F   F   F   F   f   f   f   M   M   M   M   D   C   s   s   s   s   M
r   r   F   f   C   F   H   M   D   H   M   M   M   M   H   s   s   f   F   M
M   F   W   W   W   H   M   M   f   D   H   M   M   M   H   f   f   s   s   M
M   F   W   D   W   H   H   M   C   M   H   D   M   H   f   s   s   D   s   M
M   F   W   W   W   H   H   D   M   H   M   H   f   f   s   f   s   s   s   M
M   M   M   M   M   M   M   M   M   M   M   M   M   M   M   M   M   M   M   M